require("Levels").addLevel("lvl0", {
  "width": "20",
  "height": "16",
  "player": {
    "x": 1,
    "y": 1
  },
  "winScore": 24,
  "maxTime": 300,
  "tiles": ["#","#","#","#","#","#","#","#","#","#","#","#","#","#","#","#","#","#","#","#",
            "#","@","+","+",".","#","*","*","#","*","*","#","*","*",".",".",".",".",".","#",
            "#","."," ","#",".","#",".","+","#","+",".","#",".",".",".",".",".",".",".","#",
            "#","."," ","#","*","#",".","#","#","#",".","#",".",".",".",".",".",".",".","#",
            "#","."," ",".",".",".",".",".",".",".",".",".",".",".",".",".",".",".",".","#",
            "#","#"," ","#","#","#","#","#","#","#","#",".","#","#","#","#","."," ",".","#",
            "#","."," ","Q",".",".",".",".",".",".",".",".","*","*","*","#","."," ",".","#",
            "#","."," ",".",".",".",".",".",".",".",".",".","*","*","*","#","."," ",".","#",
            "#","."," ",".",".",".","."," ",".",".",".",".","*","*",".","#","."," ",".","#",
            "#","."," ",".",".","."," "," ",".",".",".",".","*","*",".","#","."," ",".","#",
            "#","."," ",".",".",".",".",".",".",".",".",".","*","*","+","#","."," ",".","#",
            "#","#",".",".",".",".","+","#","#","#",".","#","#","#","#","#","."," ",".","#",
            "#",".",".",".",".",".",".",".",".",".",".",".",".",".",".","#","."," ",".","#",
            "#",".","#","."," "," ",".",".",".",".",".",".",".",".",".","#",".","Q",".","#",
            "E"," "," "," ","Q"," ",".",".",".",".",".",".",".",".",".","#",".","+",".","#",
            "#","#","#","#","#","#","#","#","#","#","#","#","#","#","#","#","#","#","#","#"]
});