require("Levels").addLevel("lvl1", {
  "width": "20",
  "height": "16",
  "player": {
    "x": 2,
    "y": 10
  },
  "winScore": 19,
  "maxTime": 150,
  "tiles": ["#","#","#","#","#","#","#","#","#","#","#","#","#","#","#","#","#","#","#","#",
            "#",".",".",".","*","*","*","*","*","*","*","#","Q"," "," ","#","Q"," "," ","#",
            "#",".",".",".","*","*","*","*","*","*","*","#"," "," "," ","#"," "," "," ","#",
            "#"," ",".",".","+","+","+","+","+","+","+","#"," "," "," ","#"," "," "," ","#",
            "#","*"," ",".","+","+","+","+","+","+","+","#","+"," "," ","#","+"," "," ","#",
            "#","#"," ","#","#","#","#","#","#","#","#","#",".",".",".",".",".",".",".","#",
            "#","."," ",".",".",".",".",".",".",".",".","#",".",".",".",".",".",".",".","#",
            "#","."," "," ",".",".",".",".",".",".",".","#",".",".",".",".",".",".",".","#",
            "#","."," "," ",".",".",".","*",".",".",".",".",".",".",".",".",".",".",".","#",
            "#","."," "," ",".",".","*","*","*",".",".","#",".",".",".",".",".",".",".","#",
            "#",".","@"," ",".","*","*","*","*","*",".","#",".",".",".",".",".",".",".","#",
            "#","#","#"," ","#","#","#","#","#","#","#","#",".",".",".",".",".",".",".","#",
            "#",".","*"," ","."," "," "," "," ",".","#","*",".",".",".",".",".",".",".","#",
            "#",".","*"," ","."," "," "," "," ",".","#","*","+","*",".",".",".",".",".","#",
            "#",".","*"," ","."," "," "," "," ",".","#","+","+","*",".",".",".",".",".","#",
            "#","#","#","#","#","#","#","#","E","#","#","#","#","#","#","#","#","#","#","#"]
});