require("Levels").addLevel("lvl2", {
  "width": "20",
  "height": "16",
  "player": {
    "x": 2,
    "y": 6
  },
  "winScore": 15,
  "maxTime": 80,
  "tiles": ["#","#","#","#","#","#","#","#","#","#","#","#","#","#","#","#","#","#","#","#",
            "E","+",".",".","+","*","*","*","*","*","*","#",".",".","."," "," "," "," ","#",
            "#"," ",".",".","*","+","*","*","*","+","*","+",".",".","."," ",".","."," ","#",
            "#"," ",".",".","*","*","+","*","+","*","*","#",".",".","."," ",".","."," ","#",
            "#"," ",".",".","*","*","*","+","*","*","*","#",".",".","."," ",".","."," ","#",
            "#","#","#","#","#","#","#",".","#","#","#","#",".",".","."," ",".","."," ","#",
            "#"," ","@",".",".","."," ","."," ",".",".","#",".",".","."," ",".","."," ","#",
            "#"," ","*"," "," "," "," "," "," "," "," ","#",".",".","."," ",".","."," ","#",
            "#"," ","*"," "," "," "," "," "," "," "," ","#",".",".",".","Q",".","."," ","#",
            "#"," ","*"," "," "," "," "," "," "," "," ","#"," ",".","."," ",".","."," ","#",
            "#"," ","*"," "," "," "," "," "," "," "," ","#","+",".","."," ",".","."," ","#",
            "#","#","#","#","#","#","#","#","#","#","#","#","#"," ","#","Q",".","."," ","#",
            "#"," ","*"," "," "," "," "," "," "," "," ","#",".",".","#"," ",".","."," ","#",
            "#","+","*"," "," "," "," "," "," "," "," ","#",".",".","#"," "," "," "," ","#",
            "#","+","*","+"," "," "," "," "," "," "," ","+",".",".","#",".","+","+",".","#",
            "#","#","#","#","#","#","#","#","#","#","#","#","#","#","#","#","#","#","#","#"]
});