require("Levels").addLevel("lvl3", {
  "width": "20",
  "height": "16",
  "player": {
    "x": 10,
    "y": 9
  },
  "winScore": 21,
  "maxTime": 120,
  "tiles": ["#","#","#","#","#","#","#","#","#","#","#","#","#","#","#","#","#","#","#","#",
            "#","*","*","-","-","-","-","-","-","-","-","-","-","-","-","-",".","*",".","#",
            "#","*","-","-","-","-","*","-","-","-","-"," "," ","-","-","*","*",".",".","#",
            "#","-","-","-","-","-","-","-","-","-","-"," "," ","-","-","-","*",".",".","#",
            "#","-","-","-"," "," "," ","-"," ","-","-","*","*","-","-","*",".",".","*","#",
            "#","-","-","-"," ","Q"," ","-","-","-","-","-","-","-","-","-",".",".",".","#",
            "#","-","*","-"," ","+"," ","-","-","-","-","*","*","-","-","-","-","*","-","#",
            "#","-","-","-","-","-","-","-","-","-","-","-","-","-","*","-","-","-","-","#",
            "#","-","-","-","-","-","-","-","-","-","-","#","#","#","#","#","#","#","#","#",
            "#","-","-","-","-","-","-","-","-","-","@","#","-","-","-","-",".","*",".","#",
            "#","-","-","-","-","-","-","-"," ","-","-","#","-","-","-","*",".",".",".","#",
            "#","-","-","-"," "," "," ","-","-","-","-","#","-","-","-","-",".",".",".","E",
            "#","-","-","-"," ","Q"," ","-","-","-","*","#","-","+","-","-",".","*",".","#",
            "#","-","-","-"," ","+"," ","-","-","*","*","#","+","+","+","-",".",".",".","#",
            "#","*","-","-","-","-","-","-","-","*","*","#","+","+","+","-","*",".",".","#",
            "#","#","#","#","#","#","#","#","#","#","#","#","#","#","#","#","#","#","#","#"]
});