require("Levels").addLevel("lvl4", {
  "width": "20",
  "height": "16",
  "player": {
    "x": 10,
    "y": 9
  },
  "winScore": 5,
  "maxTime": 180,
  "tiles": ["#","#","#","#","#","#","#","#","#","#","#","#","#","#","#","#","#","#","#","#",
            "#",".",".",".",".",".",".",".",".",".",".",".",".",".",".","-",".",".",".","#",
            "#",".",".",".",".",".",".",".",".",".",".",".",".",".",".","-",".",".",".","#",
            "#",".",".",".",".",".",".",".",".",".",".",".",".",".",".","-",".",".",".","#",
            "#",".",".","#",".","#"," ","#",".","#",".",".",".","#","-","#"," ","#",".","#",
            "#",".",".","#"," ","#"," ","#","Q","#",".",".",".","#",".","#"," ","#",".","#",
            "#",".",".","#","Q","#",".","#","+","#",".",".",".","#",".","#"," ","#",".","#",
            "#",".",".","#","+","#",".","#","#","#",".",".","#","#",".","#","Q","#",".","#",
            "#",".",".","#","#","#",".",".",".",".",".",".","#","#",".","#","+","#",".","#",
            "#",".",".",".",".",".",".",".",".",".","@","#",".","#",".","#","#","#",".","#",
            "#","#","#","#","#","#","#","."," ",".",".","#",".","#",".","-",".",".",".","#",
            "#","#"," ","Q"," "," "," "," "," ",".",".",".",".","#","#","#","#","#","#","#",
            "E","."," ","#","#","#",".","#"," ",".",".",".",".",".",".","-",".",".",".","#",
            "#","#"," ","#",".",".",".","#"," ",".",".",".","#",".",".","-",".",".",".","#",
            "#","#","+","#",".",".",".","."," "," "," "," ","#","-","-","-",".",".","+","#",
            "#","#","#","#","#","#","#","#","#","#","#","#","#","#","#","#","#","#","#","#"]
});