require("Levels").addLevel("lvl5", {
  "width": "40",
  "height": "20",
  "player": {
    "x": 1,
    "y": 3
  },
  "winScore": 43,
  "maxTime": 400,
  "tiles": ["#","#","#","#","#","#","#","#","#","#","#","#","#","#","#","#","#","#","#","#","#","#","#","#","#","#","#","#","#","#","#","#","#","#","#","#","#","#","#","#",
            "#",".",".","+",".",".",".",".",".",".",".",".",".",".",".","*",".",".",".",".",".","*",".",".","*",".",".","*",".",".","*"," "," "," ",".",".",".",".",".","#",
            "#",".",".","*",".",".","*",".",".",".",".","*",".",".","*",".","*",".",".",".",".","*","*",".","*",".",".",".",".","*","*","Q"," "," ",".",".",".","*",".","#",
            "#","@",".",".",".",".","*",".",".","*","*",".",".",".","*","*","*",".",".",".",".","*",".","*","*",".",".",".",".","*",".",".",".",".","*","*",".",".",".","#",
            "#",".",".","*","*",".","*","+",".",".",".",".",".",".","*",".","*",".",".",".",".","*",".",".","*",".",".",".",".",".",".","+",".",".",".",".",".","*","+","#",
            "#","#","#","#","#","#","#","#","#","#","#","#","#","#","#","#","#","#","#","#",".","#","#","#","#","#","#","#","#","#","#","#","#","#","#","#","#","#","#","#",
            "#","*","*","*","*","*","*","*",".",".",".",".",".",".",".",".",".",".",".",".",".",".",".",".",".",".",".",".",".",".",".",".","."," "," "," "," "," "," ","#",
            "#",".","*","*","*","*","*",".",".",".",".",".",".",".","*","*",".",".",".",".",".",".",".","*","*","*",".",".",".",".",".",".","."," ",".",".",".",".","Q","#",
            "#",".",".","*","*","*","*",".",".",".",".",".",".","*",".",".",".",".",".",".",".",".",".","*",".",".",".",".",".",".","*",".",".","Q",".",".",".","."," ","#",
            "#",".",".","*",".",".",".",".",".",".",".",".",".","*",".","*","*",".",".",".",".",".",".","*","*","*",".",".",".",".","+",".","."," ",".",".",".",".","Q","#",
            "#","+","*",".",".","*","*",".",".",".",".",".",".","*",".",".","*",".",".",".",".",".",".",".",".","*",".",".",".",".",".",".",".","Q",".",".",".","."," ","#",
            "#",".",".",".","*","*","*",".",".",".",".",".",".",".","*","*",".",".",".",".",".",".",".","*","*","*",".",".",".",".",".",".","."," "," ","Q"," ","Q"," ","E",
            "#","#","#","#","#","#","#","#","#","#","#","#","#","#","#","#","#","#","#","#",".","#","#","#","#","#","#","#","#","#","#","#","#","#","#","#","#","#","+","#",
            "#",".",".",".",".",".",".",".",".",".",".",".",".",".",".",".","*",".",".",".",".",".",".","*",".",".",".",".",".",".",".",".",".",".",".",".","*",".",".","#",
            "#",".",".","*",".",".",".",".",".",".",".",".",".",".",".",".",".",".",".","*",".",".",".",".",".",".",".",".",".",".",".",".",".",".",".",".",".",".",".","#",
            "#",".",".",".",".",".",".",".",".",".",".",".",".",".",".",".",".",".",".",".",".",".",".",".",".",".",".",".",".",".",".",".",".",".",".",".",".",".",".","#",
            "#"," "," "," ",".","."," "," "," ",".","."," "," "," ",".","."," "," "," ",".",".",".",".",".",".",".",".",".",".",".",".",".",".",".",".",".",".",".",".","#",
            "#"," "," "," ",".","."," "," "," ",".","."," "," "," ",".","."," "," "," ",".",".",".",".",".",".",".",".",".",".",".",".",".",".",".",".",".",".",".",".","#",
            "#"," "," ","Q",".","."," ","Q"," ",".","."," ","Q"," ",".","."," ","Q"," ",".",".",".",".",".",".",".",".",".",".",".",".",".",".",".",".",".",".",".",".","#",
            "#","#","#","#","#","#","#","#","#","#","#","#","#","#","#","#","#","#","#","#","#","#","#","#","#","#","#","#","#","#","#","#","#","#","#","#","#","#","#","#"]
});